weaponSwitch	weaponSwitchSound
error	errorSound
jump	JumpSound
death	DeathCrySound
pain	PainCrySound
underWater1	ArmorMoveBubblesSound
underWater1	WaterBreathMaleSound
splash1	Splash1Sound
exitWater	exitWaterSound
playerMount	playerMountSound
bodyRemove	deathExplosionSound
spawn	spawnExplosionSound
hammerHit	hammerHitSound
glassBreak	glassExplosionSound
wrenchHit	wrenchHitSound
wrenchMiss	wrenchMissSound
wandHit	wandHitSound
sprayLoop	sprayFireSound
sprayActivate	sprayActivateSound
lightOn	lightOnSound
lightOff	lightOffSound
orchHitH	rewardSound
printFire	printFireSound
vehicleExplosion	vehicleExplosionSound
DoorBell_1	DoorBell_1
DoorBell_2	DoorBell_2
DoorBell_3	DoorBell_3
DoorBell_4	DoorBell_4
DoorBell_5	DoorBell_5
DoorBell_6	DoorBell_6
DoorBell_7	DoorBell_7
COD4_Bloody_Hell	COD4_Bloody_hell_Sound
COD4_Bomb_defused	COD4_Bomb_defused_Sound
COD4_Challenge_complete	COD4_Challenge_complete_Sound
COD4_Charges_set	COD4_Charges_set_Sound
COD4_Cover_me	COD4_Cover_me_Sound
COD4_Fire_hole	COD4_Fire_hole_Sound
COD4_Get_back	COD4_Get_back_Sound
COD4_Grenade	COD4_Grenade_Sound
COD4_Lets_do	COD4_Lets_do_Sound
COD4_Planting_claymore	COD4_Planting_claymore_Sound
COD4_Tango_down	COD4_Tango_down_Sound
COD4_Target_nutrilized	COD4_Target_nutrilized_Sound
COD4_Tosing_stun	COD4_Tosing_stun_Sound
COD4_We_defeated	COD4_We_defeated_Sound
COD4_We_defeatedtwo	COD4_We_defeatedtwo_Sound
COD4_We_lost	COD4_We_lost_Sound
COD4_We_losttwo	COD4_We_losttwo_Sound
COD4_We_victorious	COD4_We_victorious_Sound
cash_register	cash_register
BAN_Button1	BAN_Button1
BAN_Button2	BAN_Button2
BAN_Button3	BAN_Button3
BAN_Console_Blip	BAN_Console_Blip
BAN_DescendingBeep	BAN_DescendingBeep
BAN_PowerAscend	BAN_PowerAscend
BAN_PowerDescend	BAN_PowerDescend
Airplane_DingDong	Airplane_DingDong_sound
Airplane_Dong	Airplane_Dong_sound
GPWS_Pull_Up	Airplane_PullUp_sound
GPWS_Sink_Rate	Airplane_SinkRate_sound
GPWS_Dont_Sink	Airplane_DontSink_sound
Airlock_open	airlock_open
10	GPWS10_Sound
20	GPWS20_Sound
30	GPWS30_Sound
40	GPWS40_Sound
50	GPWS50_Sound
100	GPWS100_Sound
200	GPWS200_Sound
300	GPWS300_Sound
400	GPWS400_Sound
500	GPWS500_Sound
1000	GPWS1000_Sound
2500	GPWS2500_Sound
cabbell	cabbell_Sound
cabbell2	cabbell2_Sound
sinkrate	sinkrate_Sound
minimums	minimums_Sound
approachingmins	approachingmins_Sound
jetengine	jetengine_Sound
jetstartup	jetstartup_Sound
pullup	pullup_Sound
terrain	terrain_Sound
windshear	windshear_Sound
Access_Denied	Access_Denied_Sound
Access_Granted	Access_Granted_Sound
Yawn	Yawn_Sound
Dogbark	DogBark_Sound
Doggrowl	DogGrowl_Sound
CatMeow	CatMeow_Sound
MyLeg	MyLeg_Sound
Ghost	Ghost_Sound
Laugh	Laugh_Sound
PotatoChips	PotatoChips_Sound
Cricket	Cricket_Sound
Cricket2	Cricket_2_Sound
Golfball	Golf_ball_Sound
Sprinkler	Sprinkler_Sound
Thunder	Thunder_Sound
Thunder2	Thunder2_Sound
Writing	Writing_Sound
Printer2	Printer2_Sound
Keyboard	Keyboard_Sound
Printer1	Printer1_Sound
KeyboardSingle	KeyboardSingle_Sound
MouseClick	MouseClick_Sound
Dryer	Dryer_Sound
WashingMachine	Washing_Machine_Sound
Refrigerator Door Shut	Refrigerator_Door_Shut_Sound
Blender	Blender_Sound
Refrigerator Hum	Refrigerator_Hum_Sound
Chair Slide	Chair_Slide_Sound
Microwave	Microwave_Sound
Foursteps	Four_Steps_Sound
Singlestep	Singlestep_Sound
Door Knock	Door_Knock_Sound
Creaky Door	Creaky_Door_Sound
Creaky door Open	Creaky_Door_Open_Sound
Doorbell	Doorbell_Sound
Bell Alarm Clock	Bell_Alarm_Clock_Sound
Digital Alarm Clock	Digital_Alarm_Clock_Sound
Digital Alarm Clock 2	Digital_Alarm_Clock_2_Sound
Lightswitch	Lightswitch_Sound
Toilet_Flush	Toilet_Flush_Sound
river	River_Sound
Shower	Shower_Sound
showerrunning	showerrunning_Sound
HairDryer	HairDryer_Sound
ZombieMoan1	Zombie_Moan_Sound
ZombieMoan2	Zombie_Moan_Short_Sound
Locked_Door	Locked_Door_Sound
Suit_Warning	Suit_Warning_Sound
WeaponHud_Deny_Select	Weapon_Select_Cancel_Sound
WeaponHud_Off	Weapon_Select_Sound
WeaponHud_MoveSelection	Weapon_Select_Move_Sound
WeaponHud_Select	Use_Sound
Buttonclick	Buttonclick_Sound
Buttonclick_release	Buttonclick2_Sound
Button_rollover	Button_Select_Sound
Ammo_pickup	Ammo_Pickup_Sound
Ammunition_crate_open	Ammocrate_Open_Sound
Ammunition_crate_close	Ammocrate_Close_Sound
Battery_pickup	Armor_Battery_Pickup_Sound
Flashlight_Click	TorchToggle_Sound
Wall_Medkit_Use2	Medkit_Wall_Useloop_Sound
Wall_Medkit_Use_Start	Medkit_Wall_Usestart_Sound
Wall_Medkit_Deny	Medkit_Wall_Deny_Sound
Medkit	Medkit_Pickup_Sound
HEV_Suit_Charge2	HEV_Chargeloop_Sound
HEV_Suit_Charge_Start	HEV_Charge_Start_Sound
HEV_Suit_Charge_Deny	HEV_Charge_Deny_Sound
PortalToiletFlush	Toilet_Flush
PortalUseToiletThank	Portal_Toilet_Thank
ding_on	DingOn
ding_off	DingOff
Portal_Elevator_Hum	Portal_Elevator_Hum
Portal_Elevator_Chime	Portal_Elevator_Chime
Level_00_Entry	Level_00_Entry
Level_00_Success1	Level_00_Success1
Level_01_Entry	Level_01_Entry
Level_01_Success1	Level_01_Success1
Level_02_Entry	Level_02_Entry
Level_02_GetPortalGun1	Level_02_GetPortalGun1
Level_02_GetPortalGun2	Level_02_GetPortalGun2
Level_03_Entry	Level_03_Entry
Level_04_Entry	Level_04_Entry
soldier_youWillNotBeMissed	soldier_youWillNotBeMissed_Sound
soldier_YouAllFail	soldier_youAllFail_Sound
soldier_whatIwannase	soldier_whatIwannase_Sound
soldier_weFail	soldier_weFail_Sound
soldier_spy	soldier_spy_Sound
soldier_moveOut	soldier_moveOut_Sound
soldier_incoming	soldier_incoming_Sound
soldier_help	soldier_help_Sound
soldier_happyLaugh	soldier_happyLaugh_Sound
soldier_goodWork	soldier_goodWork_Sound
soldier_fire	soldier_fire_Sound
soldier_evilLaugh	soldier_evilLaugh_Sound
soldier_CHARGE	soldier_CHARGE_Sound
soldier_Booyah	soldier_Booyah_Sound
soldier_boo	soldier_boo_Sound
soldier_MAGGOTS	soldier_MAGGOTS_Sound
Flush	Flush_Sound
XP_Balloon	XP_Balloon_Sound
XP_Battery_Critical	XP_Battery_Critical_Sound
XP_Battery_Low	XP_Battery_Low_Sound
XP_Critical_Stop	XP_Critical_Stop_Sound
XP_Ding	XP_Ding_Sound
XP_Error	XP_Error_Sound
XP_Exclamation	XP_Exclamation_Sound
XP_Hardware_Fail	XP_Hardware_Fail_Sound
XP_Hardware_Insert	XP_Hardware_Insert_Sound
XP_Hardware_Remove	XP_Hardware_Remove_Sound
XP_Logoff_Sound	XP_Logoff_Sound
XP_Logon_Sound	XP_Logon_Sound
XP_Notify	XP_Notify_Sound
XP_Recycle	XP_Recycle_Sound
XP_Shutdown	XP_Shutdown_Sound
XP_Startup	XP_Startup_Sound
TF2TeleSend	TeleporterSend
TF2TeleReady	TeleporterReady
TF2TeleReceive	TeleporterReceive
TF2TeleRecharge	TeleporterSpin1
TF2TeleRecharge2	TeleporterSpin2
TF2TeleRecharge3	TeleporterSpin3
DoomTele	DoomTeleport
CQTele	ChexQuestTeleport
QuakeTele1	QuakeTele1
QuakeTele2	QuakeTele2
QuakeTele3	QuakeTele3
QuakeTele4	QuakeTele4
QuakeTele5	QuakeTele5
Quake3TeleIn	TeleIn
Quake3TeleOut	TeleOut
StarTrekTransporter	StarTrekTransporter
swordDraw	swordDrawSound
swordHit	swordHitSound
spearHit	spearExplosionSound
spearFire	spearFireSound
rocketFire	rocketFireSound
tntExplode	rocketExplodeSound
rocketLoop	rocketLoopSound
pushBroomHit	pushBroomHitSound
pushBroomSwing	pushBroomSwingSound
crit_hit	critHitSound
crit_received	critRecieveSound
crit_fire	critFireSound
tf2MeleeClangA	tf2MeleeHitBrickSoundA
tf2MeleeClangB	tf2MeleeHitBrickSoundB
tf2MeleeHit	tf2MeleeHitPlayerSound
tf2MeleeSwing	tf2MeleeSwingSound
guitar_hit_world_01	l4bGuitarHitSoundA
guitar_hit_world_02	l4bGuitarHitSoundB
melee_frying_pan_01_quiet	l4bPanHitSoundA
melee_frying_pan_02_quiet	l4bPanHitSoundB
machete_impact_flesh1	l4bMacheteHitSoundA
machete_impact_flesh2	l4bMacheteHitSoundB
melee_tonfa_01	l4bBatonHitSoundA
melee_tonfa_02	l4bBatonHitSoundB
knife_swing	KnifeFireSound
melee_knife_02	CombatKnifeHitSoundA
melee_knife_01	CombatKnifeHitSoundB
ice_axe_hit1	l4bIceaxeHitSoundA
ice_axe_hit2	l4bIceaxeHitSoundB
sledge_hammer_hit1	l4bsledgehammerHitSoundA
sledge_hammer_hit2	l4bsledgehammerHitSoundB
jumpHorse	HorseJumpSound
gunShot1	gunShot1Sound
bulletHit	bulletHitSound
arrowHit	arrowHitSound
bowFire	bowFireSound
fastimpact	fastImpactSound
slowimpact	slowImpactSound
shot	TankShotSound
whistle	WhistleLoopSound
Synth4_12	Synth_12_Sound
Synth4_13	Synth_13_Sound
Synth4_14	Synth_14_Sound
Synth4_15	Synth_15_Sound
Synth4_16	Synth_16_Sound
Synth4_17	Synth_17_Sound
Synth4_18	Synth_18_Sound
Synth4_19	Synth_19_Sound
Synth4_20	Synth_20_Sound
Synth4_21	Synth_21_Sound
Synth4_22	Synth_22_Sound
Synth4_23	Synth_23_Sound
Synth4_24	Synth_24_Sound
Synth4_00	Synth_00_Sound
Synth4_01	Synth_01_Sound
Synth4_02	Synth_02_Sound
Synth4_03	Synth_03_Sound
Synth4_04	Synth_04_Sound
Synth4_05	Synth_05_Sound
Synth4_06	Synth_06_Sound
Synth4_07	Synth_07_Sound
Synth4_08	Synth_08_Sound
Synth4_09	Synth_09_Sound
Synth4_10	Synth_10_Sound
Synth4_11	Synth_11_Sound
Phone_Ring_1	Phone_Ring_1_Sound
Phone_Ring_2	Phone_Ring_2_Sound
Phone_Ring_Bell	Phone_Ring_Bell_Sound
Phone_Ring_Harsh	Phone_Ring_Harsh_Sound
Phone_Tone_1	Phone_Tone_1_Sound
Phone_Tone_2	Phone_Tone_2_Sound
Phone_Tone_3	Phone_Tone_3_Sound
Phone_Tone_4	Phone_Tone_4_Sound
Beep_Checkout	Beep_Checkout_Sound
Beep_Denied	Beep_Denied_Sound
Beep_EKG	Beep_EKG_Sound
Beep_Key	Beep_Key_Sound
Beep_No	Beep_No_Sound
Beep_NoWay	Beep_NoWay_Sound
Beep_Popup	Beep_Popup_Sound
Beep_Siren	Beep_Siren_Sound
Beep_TryAgain	Beep_TryAgain_Sound
radioWaveExplosion	radioWaveExplosionSound
radioWaveTravel	radioWaveTravelSound
pongWallHit	pongWallHitSound
pongScore	pongScoreSound
contentSoundError	contentError
contentSoundStopLightSwitch	contentSoundStopLightSwitch
contentSoundStartLightSwitch	contentSoundStartLightSwitch
contentSoundValve	contentSoundValve
contentSoundStopButton	contentSoundStopButton
contentSoundStartButton	contentSoundStartButton
contentSoundLever	contentSoundLever
contentSoundStopAIM	contentSoundStopAIM
contentSoundStartAIM	contentSoundStartAIM
contentSoundStopCellDoor	contentSoundStopCellDoor
contentSoundStartCellDoor	contentSoundStartCellDoor
contentSoundStopGarageDoor	contentSoundStopGarageDoor
contentSoundStartGarageDoor	contentSoundStartGarageDoor
contentSoundStopHatch	contentSoundStopHatch
contentSoundStartHatch	contentSoundStartHatch
contentSoundStopSaloonDoor	contentSoundStopSaloonDoor
contentSoundStartSaloonDoor	contentSoundStartSaloonDoor
contentSoundStopSecurityDoor	contentSoundStopSecurityDoor
contentSoundStartSecurityDoor	contentSoundStartSecurityDoor
impact1A	Impact1ASound
impact2A	Impact2ASound
impact1B	Impact1BSound
alarm	AlarmSound
contentSoundstopwoodengate	contentSoundstopwoodengate
contentSoundstartwoodengate	contentSoundstartwoodengate
contentSoundStopGateDoor	contentSoundStopGateDoor
contentSoundStartGateDoor	contentSoundStartGateDoor
contentSoundMedi	contentSoundMedi
contentSoundShojiDoor	contentSoundShojiDoor
pullchainrelease	pullchainrelease
pullchainpull	pullchainpull
contentSoundStopPressureDoor	contentSoundStopPressureDoor
contentSoundStartPressureDoor	contentSoundStartPressureDoor
contentSoundHangarDoor	contentSoundHangarDoor
contentSoundElevatorDoor	contentSoundElevatorDoor
contentSoundSlidingDoor	contentSoundSlidingDoor
contentSoundStopBlastDoorSmall	contentSoundStopBlastDoorSmall
contentSoundStopfan	contentSoundStopfan
contentSoundStartfan	contentSoundStartfan
contentSoundStopGiantFan	contentSoundStopGiantFan
contentSoundStartGiantFan	contentSoundStartGiantFan
contentSounddialswitch	contentSounddialswitch
contentSoundStopGate	contentSoundStopGate
contentSoundStartGate	contentSoundStartGate
contentSoundBathroomDoorClose	contentSoundBathroomDoorClose
contentSoundBathroomDoorOpen	contentSoundBathroomDoorOpen
contentSoundFridgeClose	contentSoundFridgeClose
contentSoundFridgeOpen	contentSoundFridgeOpen
contentSoundFutureDoor	contentSoundFutureDoor
